1111111111111111
1P10001000000001
10101011110111E1
1010100000011111
1010001010110001
1011111110000101
1000001C11110101
1011101011010111
100C101000010001
1010101111010111
10001000000000C1
1111111111111111