1111111111111111111111
11P10000010000000C0101
1101010101011101110101
1000010101000100010001
1111110101110111011101
10000C0100010001000101
1101110111111101110111
1000010100000000010C01
1111011101111111011101
1000010001C10100000101
1101110111010111111101
1000010001010100000101
1101011101010101110101
1101000000010001E00001
1111111111111111111111
