1111111111111
1P0000C0001E1
1111111111111
