1111111111111
1P0000C000001
1000011100001
1000C1C1C00E1
1111111111111
